ticker,cik,name,10K_files,10Q_files,k_count,q_count,total
AMCR,0000011199,Bemis Company,"['0000011199-13-000011', '0000011199-14-000006', '0000011199-15-000006', '0000011199-16-000036', '0000011199-17-000011', '0000011199-18-000012', '0000011199-19-000006', '0001104659-03-004994', '0001104659-04-007445', '0001104659-05-010653', '0001104659-06-016718', '0001104659-07-015628', '0001104659-08-014023', '0001104659-09-012842', '0001104659-10-010599', '0001104659-11-011309', '0001104659-12-014367']","['0000011199-12-000011', '0000011199-13-000018', '0000011199-13-000024', '0000011199-13-000035', '0000011199-14-000013', '0000011199-14-000023', '0000011199-14-000029', '0000011199-15-000012', '0000011199-15-000021', '0000011199-15-000030', '0000011199-16-000044', '0000011199-16-000053', '0000011199-16-000065', '0000011199-17-000022', '0000011199-17-000031', '0000011199-17-000050', '0000011199-18-000027', '0000011199-18-000038', '0000011199-18-000045', '0000011199-19-000012', '0000912057-00-035180', '0000912057-00-049151', '0001104659-01-500406', '0001104659-01-501720', '0001104659-01-502663', '0001104659-02-001626', '0001104659-02-003192', '0001104659-02-005337', '0001104659-03-008242', '0001104659-03-018361', '0001104659-03-025311', '0001104659-04-013013', '0001104659-04-022932', '0001104659-04-034588', '0001104659-05-022015', '0001104659-05-037506', '0001104659-05-052987', '0001104659-06-033365', '0001104659-06-053124', '0001104659-06-072629', '0001104659-07-038036', '0001104659-07-060168', '0001104659-07-081520', '0001104659-08-031753', '0001104659-08-049877', '0001104659-08-069515', '0001104659-09-031285', '0001104659-09-048606', '0001104659-09-063664', '0001104659-10-027335', '0001104659-10-042993', '0001104659-10-057201', '0001104659-11-027668', '0001104659-11-061502', '0001104659-12-035636']",17,55,72
AVGO,0001441634,Avago Technologies,"['0000950123-10-113875', '0001193125-09-253349', '0001441634-12-000010', '0001441634-13-000013', '0001441634-14-000049', '0001441634-15-000089', '0001445305-11-003592']","['0000950123-11-023882', '0000950123-11-057877', '0000950123-11-083475', '0001193125-09-187012', '0001193125-10-047952', '0001193125-10-132134', '0001193125-10-203893', '0001441634-12-000004', '0001441634-12-000007', '0001441634-13-000003', '0001441634-13-000005', '0001441634-13-000007', '0001441634-14-000018', '0001441634-14-000045', '0001441634-14-000047', '0001441634-15-000002', '0001441634-15-000023', '0001441634-15-000048', '0001445305-12-000606']",7,19,26
AVGO,0001054374,Broadcom Corp,"['0000892569-02-000531', '0000892569-03-000851', '0000892569-04-000339', '0000892569-07-000139', '0000892569-08-000087', '0000950123-10-008370', '0000950123-11-008273', '0000950134-05-003964', '0000950134-06-002774', '0000950134-09-001749', '0001054374-13-000018', '0001054374-14-000012', '0001054374-15-000012', '0001193125-12-033198']","['0000892569-01-500702', '0000892569-01-501081', '0000892569-02-001136', '0000892569-02-001800', '0000892569-02-002319', '0000892569-03-001354', '0000892569-03-001907', '0000892569-03-002518', '0000892569-05-000554', '0000892569-05-000944', '0000892569-06-000653', '0000892569-07-000033', '0000892569-07-000034', '0000892569-07-000550', '0000892569-07-000946', '0000892569-07-001318', '0000892569-09-000455', '0000950123-09-024912', '0000950123-09-052329', '0000950123-10-038903', '0000950123-10-068586', '0000950123-10-096130', '0000950123-11-039337', '0000950123-11-067892', '0000950123-11-091780', '0000950134-05-008878', '0000950134-08-007222', '0000950134-08-013120', '0000950134-08-018252', '0000950137-04-003850', '0000950137-04-006460', '0001054374-12-000021', '0001054374-13-000072', '0001054374-13-000123', '0001054374-13-000149', '0001054374-14-000055', '0001054374-14-000106', '0001054374-14-000153', '0001054374-15-000062', '0001054374-15-000104', '0001054374-15-000124', '0001095811-00-002799', '0001095811-01-502342', '0001193125-12-201117', '0001193125-12-312411']",14,45,59
AVGO,0001649338,Broadcom Merged,"['0001649338-16-000151', '0001649338-17-000158']","['0001649338-16-000019', '0001649338-16-000088', '0001649338-16-000104', '0001649338-17-000027', '0001649338-17-000093', '0001649338-17-000107', '0001649338-18-000027']",2,7,9
BF,14693,.,"['0000014693-21-000091', '0001104659-21-086265', '0001104659-21-086267']","['0000014693-21-000158', '0000943440-08-000372', '0001104659-21-021707', '0001104659-21-021714', '0001104659-21-103939', '0001104659-21-103942', '0001410578-21-000076', '0001410578-21-000078']",3,8,11
BRK,1067983,.,"['0000950129-05-002423', '0000950129-06-002521', '0000950134-07-004573', '0000950134-08-003848', '0000950150-01-000114', '0000950150-02-000303', '0000950150-03-000377', '0000950150-04-000327', '0001193125-09-042055', '0001193125-10-043450', '0001193125-11-048914', '0001193125-12-079022', '0001193125-13-087679', '0001193125-14-078778', '0001193125-15-070966', '0001193125-16-483023', '0001193125-17-056969', '0001193125-18-057033', '0001193125-19-048926', '0001477932-12-002560', '0001477932-13-003611', '0001477932-14-003828', '0001477932-15-004744', '0001477932-16-011552', '0001477932-17-003995', '0001564590-20-005874', '0001564590-21-009611']","['0000950123-19-009995', '0000950129-04-002994', '0000950129-04-005709', '0000950129-04-008588', '0000950129-05-004868', '0000950129-05-007767', '0000950129-05-010572', '0000950129-06-005040', '0000950134-06-014893', '0000950134-06-020444', '0000950134-07-016772', '0000950134-07-022672', '0000950148-08-000131', '0000950150-00-000694', '0000950150-00-000904', '0000950150-01-500319', '0000950150-01-500515', '0000950150-01-500755', '0000950150-02-000490', '0000950150-02-000743', '0000950150-02-001032', '0000950150-03-000563', '0000950150-03-000865', '0000950150-03-001248', '0000950150-07-000022', '0000950150-08-000015', '0000950150-08-000030', '0001157523-09-005813', '0001157523-09-007839', '0001157523-10-002982', '0001157523-10-004882', '0001157523-10-006675', '0001157523-11-002891', '0001157523-11-004793', '0001157523-12-004238', '0001193125-09-105560', '0001193125-12-449402', '0001193125-13-199397', '0001193125-13-317399', '0001193125-14-291724', '0001193125-14-403605', '0001193125-15-166595', '0001193125-15-283231', '0001193125-15-370187', '0001193125-16-582004', '0001193125-16-673492', '0001193125-16-760194', '0001193125-17-160889', '0001193125-17-248832', '0001193125-17-332829', '0001193125-18-153460', '0001193125-18-238892', '0001193125-18-317734', '0001193125-19-137433', '0001477932-12-000891', '0001477932-12-003521', '0001477932-12-004741', '0001477932-13-000987', '0001477932-13-004083', '0001477932-13-005961', '0001477932-14-001017', '0001477932-14-004902', '0001477932-14-007050', '0001477932-15-001258', '0001477932-15-005823', '0001477932-15-007384', '0001477932-16-008964', '0001477932-16-012470', '0001477932-16-014177', '0001477932-17-001251', '0001477932-17-004603', '0001477932-20-002187', '0001564590-19-028491', '0001564590-20-020599', '0001564590-20-038544', '0001564590-20-052144', '0001564590-21-022703', '0001564590-21-042312', '0001564590-21-055032']",27,79,106
CI,0000701221,CIGNA,"['0000893220-09-000405', '0000950123-10-016612', '0000950159-03-000165', '0000950159-04-000243', '0000950159-05-000256', '0000950159-06-000332', '0000950159-07-000285', '0000950159-08-000407', '0001047469-15-001276', '0001047469-16-010432', '0001047469-17-000899', '0001047469-18-001158', '0001308179-11-000024', '0001308179-12-000042']","['0000950123-09-027787', '0000950123-09-058417', '0000950123-10-045388', '0000950123-10-073165', '0000950123-10-097957', '0000950159-00-500008', '0000950159-00-500023', '0000950159-01-500065', '0000950159-01-500189', '0000950159-01-500321', '0000950159-02-000281', '0000950159-02-000462', '0000950159-02-000708', '0000950159-03-000375', '0000950159-03-000636', '0000950159-03-000867', '0000950159-04-000468', '0000950159-04-000725', '0000950159-04-000954', '0000950159-05-000543', '0000950159-05-000888', '0000950159-05-001239', '0000950159-06-000665', '0000950159-06-001059', '0000950159-06-001448', '0000950159-07-000609', '0000950159-07-000941', '0000950159-07-001318', '0000950159-08-000757', '0000950159-08-001130', '0000950159-08-001516', '0001047469-12-007677', '0001104659-12-073103', '0001104659-13-036475', '0001104659-13-058844', '0001104659-13-079603', '0001104659-14-033290', '0001104659-14-055390', '0001104659-14-075195', '0001104659-15-032254', '0001104659-15-054796', '0001104659-15-076424', '0001104659-16-118534', '0001104659-16-135285', '0001104659-16-154504', '0001104659-17-030101', '0001104659-17-049513', '0001104659-17-065484', '0001104659-18-030187', '0001104659-18-049062', '0001104659-18-065339', '0001308179-11-000059', '0001308179-11-000081', '0001308179-11-000115', '0001308179-12-000129', '0001362310-09-006143']",14,56,70
CI,0001532063,Express Scripts,"['0001193125-13-063930', '0001532063-14-000006', '0001532063-15-000004', '0001532063-16-000017', '0001532063-17-000004', '0001532063-18-000004']","['0001193125-12-225583', '0001193125-12-340911', '0001445305-13-000961', '0001532063-13-000004', '0001532063-14-000011', '0001532063-14-000028', '0001532063-15-000007', '0001532063-15-000010', '0001532063-15-000013', '0001532063-16-000020', '0001532063-16-000023', '0001532063-16-000026', '0001532063-17-000007', '0001532063-17-000011', '0001532063-17-000014', '0001532063-18-000007', '0001532063-18-000011', '0001532063-18-000014']",6,18,24
CTRA,0000858470,Cabot Oil Gas Corp,"['0000858470-16-000036', '0000858470-17-000007', '0000858470-18-000006', '0000858470-19-000008', '0000858470-20-000012', '0000858470-21-000013', '0000899243-02-000382', '0000899243-03-000363', '0001047469-12-001751', '0001047469-13-001948', '0001047469-14-001538', '0001193125-04-025904', '0001193125-05-040899', '0001193125-06-046016', '0001193125-07-042830', '0001193125-08-039904', '0001193125-09-040956', '0001193125-10-042257', '0001193125-11-049690', '0001628280-15-001120']","['0000858470-15-000006', '0000858470-15-000015', '0000858470-15-000027', '0000858470-16-000049', '0000858470-16-000061', '0000858470-16-000066', '0000858470-17-000013', '0000858470-17-000023', '0000858470-17-000024', '0000858470-18-000022', '0000858470-18-000043', '0000858470-18-000056', '0000858470-19-000016', '0000858470-19-000032', '0000858470-19-000038', '0000858470-20-000019', '0000858470-20-000032', '0000858470-20-000049', '0000858470-21-000022', '0000858470-21-000049', '0000858470-21-000060', '0000899243-01-500206', '0000899243-01-501044', '0000899243-01-501611', '0000899243-02-001306', '0000899243-02-002113', '0000899243-02-002761', '0001104659-11-058807', '0001104659-12-029890', '0001104659-12-051649', '0001104659-12-071549', '0001104659-13-056880', '0001104659-13-077893', '0001104659-14-030311', '0001104659-14-053505', '0001193125-03-002831', '0001193125-03-026323', '0001193125-03-069476', '0001193125-04-074335', '0001193125-04-135944', '0001193125-04-180934', '0001193125-05-090413', '0001193125-05-152431', '0001193125-05-211218', '0001193125-06-103584', '0001193125-06-153901', '0001193125-06-217119', '0001193125-07-099474', '0001193125-07-165421', '0001193125-07-228218', '0001193125-08-102247', '0001193125-08-161322', '0001193125-08-221884', '0001193125-09-093943', '0001193125-09-159490', '0001193125-09-217450', '0001193125-10-100927', '0001193125-10-171983', '0001193125-10-240960', '0001193125-11-117544', '0001193125-11-202290', '0001445305-14-004439']",20,62,82
CTRA,0001168054,Cimarex Energy,"['0001047469-03-009118', '0001047469-08-001923', '0001047469-09-001974', '0001047469-10-001512', '0001047469-12-001276', '0001047469-13-001692', '0001047469-14-001366', '0001104659-04-006935', '0001104659-05-011144', '0001104659-06-015366', '0001104659-07-014852', '0001168054-18-000004', '0001168054-19-000006', '0001168054-20-000004', '0001168054-21-000008', '0001558370-15-000150', '0001558370-16-003392', '0001558370-17-000965']","['0000912057-02-042566', '0001047469-03-017905', '0001047469-03-027022', '0001047469-03-036523', '0001104659-04-012590', '0001104659-04-022527', '0001104659-04-033542', '0001104659-05-021672', '0001104659-05-037434', '0001104659-05-053135', '0001104659-06-031507', '0001104659-06-071713', '0001104659-07-037516', '0001104659-07-058246', '0001104659-07-080583', '0001104659-08-030277', '0001104659-08-049923', '0001104659-08-067883', '0001104659-09-029834', '0001104659-09-048135', '0001104659-09-062141', '0001104659-10-026823', '0001104659-10-041801', '0001104659-10-055541', '0001104659-11-026763', '0001104659-11-043622', '0001104659-12-032515', '0001104659-12-053658', '0001104659-12-073591', '0001104659-13-038109', '0001104659-13-060918', '0001104659-13-081612', '0001168054-17-000005', '0001168054-18-000010', '0001168054-18-000021', '0001168054-18-000030', '0001168054-19-000011', '0001168054-19-000017', '0001168054-19-000022', '0001168054-20-000010', '0001168054-20-000016', '0001168054-20-000023', '0001168054-21-000018', '0001168054-21-000025', '0001558370-14-000019', '0001558370-14-000103', '0001558370-14-000307', '0001558370-15-000719', '0001558370-15-001399', '0001558370-15-002220', '0001558370-16-005375', '0001558370-16-007339', '0001558370-16-009179', '0001558370-17-004140', '0001558370-17-006379']",18,55,73
DIS,0001001039,Walt Disney Co,"['0000898430-01-503823', '0000950129-04-009716', '0000950148-02-002854', '0000950148-03-002883', '0000950148-05-000128', '0001001039-13-000164', '0001001039-14-000228', '0001001039-15-000255', '0001001039-16-000516', '0001001039-17-000198', '0001001039-18-000187', '0001193125-06-241109', '0001193125-07-252227', '0001193125-08-240242', '0001193125-09-245848', '0001193125-11-321340', '0001193125-12-479027']","['0000898430-01-501889', '0000898430-02-001975', '0000950129-04-003214', '0000950129-04-005896', '0000950129-05-001088', '0000950129-05-005145', '0000950129-05-008038', '0000950129-06-001047', '0000950129-06-005209', '0000950148-04-000250', '0001001039-02-000006', '0001001039-02-000032', '0001001039-03-000002', '0001001039-03-000016', '0001001039-03-000038', '0001001039-13-000019', '0001001039-13-000080', '0001001039-13-000123', '0001001039-14-000082', '0001001039-14-000154', '0001001039-14-000195', '0001001039-15-000060', '0001001039-15-000133', '0001001039-15-000206', '0001001039-16-000362', '0001001039-16-000418', '0001001039-16-000468', '0001001039-17-000046', '0001001039-17-000092', '0001001039-17-000141', '0001001039-18-000079', '0001001039-18-000134', '0001001039-19-000062', '0001193125-06-166907', '0001193125-07-022585', '0001193125-07-106209', '0001193125-07-168199', '0001193125-08-020570', '0001193125-08-104229', '0001193125-08-161460', '0001193125-09-017678', '0001193125-09-100081', '0001193125-09-159667', '0001193125-10-025949', '0001193125-10-116299', '0001193125-10-184920', '0001193125-11-027450', '0001193125-11-134405', '0001193125-12-043966', '0001193125-12-218856', '0001193125-12-341212', '0001628280-18-001147']",17,52,69
EVRG,0001143068,Great Plains Energy Inc,"['0001143068-03-000091', '0001143068-04-000122', '0001143068-05-000120', '0001143068-06-000082', '0001143068-07-000089', '0001143068-08-000018', '0001143068-09-000017', '0001143068-10-000011', '0001143068-11-000010', '0001143068-12-000020', '0001143068-13-000020', '0001143068-14-000021', '0001143068-15-000015', '0001143068-16-000106', '0001143068-17-000011', '0001143068-18-000015']","['0000054476-08-000009', '0001143068-02-000041', '0001143068-02-000080', '0001143068-02-000152', '0001143068-03-000135', '0001143068-03-000199', '0001143068-03-000238', '0001143068-04-000158', '0001143068-04-000215', '0001143068-04-000260', '0001143068-05-000162', '0001143068-05-000207', '0001143068-05-000252', '0001143068-06-000124', '0001143068-06-000191', '0001143068-06-000237', '0001143068-07-000190', '0001143068-07-000226', '0001143068-07-000287', '0001143068-08-000058', '0001143068-08-000085', '0001143068-09-000041', '0001143068-09-000082', '0001143068-09-000098', '0001143068-10-000029', '0001143068-10-000046', '0001143068-10-000061', '0001143068-11-000032', '0001143068-11-000070', '0001143068-12-000039', '0001143068-12-000067', '0001143068-12-000088', '0001143068-13-000047', '0001143068-13-000081', '0001143068-14-000093', '0001143068-14-000117', '0001143068-15-000038', '0001143068-15-000055', '0001143068-15-000087', '0001143068-16-000125', '0001143068-16-000142', '0001143068-16-000187', '0001143068-17-000031', '0001143068-17-000050', '0001143068-17-000068', '0001143068-18-000036']",16,46,62
EVRG,54507,Westar Energy,"['0000054507-12-000007', '0000054507-13-000010', '0000054507-14-000005', '0000054507-15-000006', '0000054507-16-000043', '0000054507-17-000007', '0000054507-18-000012', '0000950130-03-003187', '0001193125-04-036423', '0001193125-05-051319', '0001193125-06-051272', '0001193125-07-044064', '0001193125-08-042143', '0001193125-09-039435', '0001193125-10-040719', '0001193125-11-045500', '0001711269-19-000013', '0001711269-20-000012', '0001711269-21-000023']","['0000054507-12-000011', '0000054507-12-000022', '0000054507-12-000029', '0000054507-13-000027', '0000054507-13-000041', '0000054507-13-000060', '0000054507-14-000011', '0000054507-14-000022', '0000054507-14-000029', '0000054507-15-000015', '0000054507-15-000027', '0000054507-15-000037', '0000054507-16-000051', '0000054507-16-000063', '0000054507-16-000070', '0000054507-17-000013', '0000054507-17-000032', '0000054507-17-000057', '0000054507-18-000030', '0000928385-02-002778', '0000950130-01-501703', '0000950130-01-503892', '0000950130-01-505319', '0000950130-02-003659', '0000950130-02-007957', '0001193125-03-005631', '0001193125-03-031074', '0001193125-03-075547', '0001193125-04-082377', '0001193125-04-130383', '0001193125-04-188064', '0001193125-05-101150', '0001193125-05-161054', '0001193125-05-215829', '0001193125-06-103796', '0001193125-06-166030', '0001193125-06-222326', '0001193125-07-106424', '0001193125-07-173976', '0001193125-07-232751', '0001193125-08-108126', '0001193125-08-170391', '0001193125-08-228231', '0001193125-09-103949', '0001193125-09-167231', '0001193125-09-217491', '0001193125-10-110956', '0001193125-10-177778', '0001193125-10-239758', '0001193125-11-128705', '0001193125-11-210530', '0001193125-11-295324', '0001711269-18-000012', '0001711269-18-000022', '0001711269-19-000034', '0001711269-19-000048', '0001711269-19-000063', '0001711269-20-000031', '0001711269-20-000045', '0001711269-20-000060', '0001711269-21-000039', '0001711269-21-000051', '0001711269-21-000062']",19,63,82
GOOG,1288776,.,"['0001193125-05-065298', '0001193125-06-056598', '0001193125-07-044494', '0001193125-08-032690', '0001193125-09-029448', '0001193125-10-030774', '0001193125-11-032930', '0001193125-12-025336', '0001193125-13-028362', '0001288776-14-000020', '0001288776-15-000008', '0001652044-16-000012']","['0001193125-04-141838', '0001193125-04-197540', '0001193125-05-108755', '0001193125-05-168339', '0001193125-05-225524', '0001193125-06-107734', '0001193125-06-167945', '0001193125-06-228163', '0001193125-07-108436', '0001193125-07-175880', '0001193125-07-238468', '0001193125-08-111739', '0001193125-08-170309', '0001193125-08-230197', '0001193125-09-101727', '0001193125-09-163845', '0001193125-09-222384', '0001193125-10-108704', '0001193125-10-172387', '0001193125-10-241317', '0001193125-11-134428', '0001193125-11-199078', '0001193125-11-282235', '0001193125-12-182401', '0001193125-12-312575', '0001193125-12-440217', '0001288776-13-000030', '0001288776-13-000055', '0001288776-13-000068', '0001288776-14-000040', '0001288776-14-000065', '0001288776-14-000075', '0001288776-15-000023', '0001288776-15-000035', '0001288776-15-000046']",12,35,47
KHC,0000046640,Heinz,"['0000046640-12-000012', '0000046640-13-000018', '0000950123-09-014732', '0000950123-10-058787', '0000950123-11-059419', '0000950152-02-005732', '0000950152-03-007052', '0000950152-04-004691', '0000950152-05-005232', '0000950152-06-005218', '0000950152-07-005237', '0000950152-08-004697']","['0000046640-11-000004', '0000046640-12-000006', '0000046640-12-000022', '0000046640-12-000030', '0000046640-13-000008', '0000046640-13-000021', '0000046640-13-000025', '0000950123-09-036965', '0000950123-09-065701', '0000950123-10-016994', '0000950123-10-082884', '0000950123-10-108028', '0000950123-11-021530', '0000950123-11-080383', '0000950128-00-001152', '0000950128-00-001416', '0000950128-01-000496', '0000950128-01-500559', '0000950128-01-500734', '0000950128-02-000268', '0000950128-02-000657', '0000950128-02-000825', '0000950128-03-000349', '0000950128-04-000867', '0000950152-03-008042', '0000950152-03-009966', '0000950152-04-008642', '0000950152-05-001612', '0000950152-05-007178', '0000950152-05-009476', '0000950152-06-001516', '0000950152-06-007360', '0000950152-06-009785', '0000950152-07-001542', '0000950152-07-007091', '0000950152-07-009331', '0000950152-08-001410', '0000950152-08-006696', '0000950152-08-009595', '0000950152-09-001710']",12,40,52
KHC,0001545158,Kraft Foods Group,"['0001193125-13-118824', '0001545158-14-000003', '0001545158-15-000018']","['0001193125-12-463555', '0001193125-13-198503', '0001545158-13-000009', '0001545158-14-000024', '0001545158-14-000108', '0001545158-15-000082']",3,6,9
LB,701985,.,"['0000701985-12-000021', '0000701985-13-000012', '0000701985-14-000013', '0000701985-15-000006', '0000701985-16-000051', '0000701985-17-000022', '0000701985-18-000018', '0000701985-19-000015', '0000701985-20-000010', '0000701985-21-000011', '0001136999-06-000405', '0001136999-06-000409', '0001136999-06-000413', '0001136999-07-000535', '0001136999-07-000538', '0001136999-07-000543', '0001136999-07-000545', '0001136999-07-000547', '0001136999-08-000368', '0001136999-08-000369', '0001136999-08-000371', '0001136999-08-000375', '0001136999-08-000386', '0001136999-09-000087', '0001193125-06-070723', '0001193125-07-073368', '0001193125-08-069148', '0001193125-09-066128', '0001193125-10-068571', '0001193125-11-071220']","['0000701985-12-000027', '0000701985-12-000035', '0000701985-12-000042', '0000701985-13-000023', '0000701985-13-000032', '0000701985-13-000043', '0000701985-14-000023', '0000701985-14-000038', '0000701985-14-000045', '0000701985-15-000014', '0000701985-15-000030', '0000701985-15-000045', '0000701985-16-000069', '0000701985-16-000083', '0000701985-16-000101', '0000701985-17-000034', '0000701985-17-000052', '0000701985-17-000067', '0000701985-18-000033', '0000701985-18-000045', '0000701985-18-000061', '0000701985-19-000028', '0000701985-19-000039', '0000701985-19-000049', '0000701985-20-000020', '0000701985-20-000036', '0000701985-20-000050', '0000701985-21-000020', '0000701985-21-000030', '0000927016-03-002907', '0000950109-01-501794', '0001021408-01-506863', '0001021408-01-511408', '0001021408-02-008471', '0001021408-02-011869', '0001021408-02-015230', '0001193125-03-048966', '0001193125-03-094376', '0001193125-04-100920', '0001193125-04-154227', '0001193125-04-209530', '0001193125-05-122558', '0001193125-05-181873', '0001193125-05-238121', '0001193125-06-123626', '0001193125-06-184064', '0001193125-06-245346', '0001193125-07-132599', '0001193125-07-198279', '0001193125-07-261404', '0001193125-08-129244', '0001193125-08-191095', '0001193125-08-248807', '0001193125-09-126165', '0001193125-09-187824', '0001193125-09-247593', '0001193125-10-132137', '0001193125-10-205694', '0001193125-10-273759', '0001193125-11-158436', '0001193125-11-237936', '0001445305-11-003514']",30,62,92
LUMN,18926,.,"['0000018926-02-000003', '0000018926-03-000005', '0000018926-04-000018', '0000018926-05-000025', '0000018926-06-000018', '0000018926-08-000004', '0000018926-09-000008', '0000018926-10-000004', '0000018926-11-000006', '0000018926-15-000008', '0000018926-16-000047', '0000018926-17-000013', '0000018926-18-000012', '0000018926-19-000006', '0000018926-20-000009', '0000018926-21-000017', '0001047469-12-001666', '0001047469-13-002037', '0001140361-07-004700', '0001445305-14-000656']","['0000018926-01-500005', '0000018926-01-500017', '0000018926-01-500023', '0000018926-02-000009', '0000018926-02-000020', '0000018926-02-000028', '0000018926-03-000036', '0000018926-03-000052', '0000018926-03-000069', '0000018926-04-000024', '0000018926-04-000040', '0000018926-04-000056', '0000018926-05-000038', '0000018926-05-000074', '0000018926-05-000092', '0000018926-06-000038', '0000018926-07-000006', '0000018926-07-000014', '0000018926-07-000019', '0000018926-08-000011', '0000018926-08-000020', '0000018926-08-000022', '0000018926-09-000011', '0000018926-09-000032', '0000018926-09-000043', '0000018926-10-000013', '0000018926-10-000023', '0000018926-10-000031', '0000018926-11-000021', '0000018926-14-000011', '0000018926-14-000019', '0000018926-15-000017', '0000018926-15-000025', '0000018926-15-000041', '0000018926-16-000055', '0000018926-16-000062', '0000018926-16-000070', '0000018926-17-000023', '0000018926-17-000055', '0000018926-17-000074', '0000018926-18-000020', '0000018926-18-000023', '0000018926-18-000029', '0000018926-19-000012', '0000018926-19-000018', '0000018926-19-000022', '0000018926-20-000016', '0000018926-20-000022', '0000018926-20-000028', '0000018926-21-000028', '0000018926-21-000041', '0000018926-21-000049', '0001047469-11-007154', '0001047469-11-009154', '0001047469-12-005754', '0001047469-12-008037', '0001047469-12-010265', '0001047469-13-005870', '0001047469-13-008255', '0001140361-06-015701', '0001445305-13-002854', '0001445305-14-002030']",20,62,82
MDT,64670,.,"['0000064670-13-000006', '0000064670-14-000010', '0000897101-01-500449', '0000897101-05-001490', '0000897101-06-001326', '0000897101-07-001326', '0000897101-08-001392', '0000897101-09-001266', '0000897101-10-001328', '0000897101-11-001132', '0000897101-12-001054', '0000912057-02-027975', '0001047469-03-024039', '0001047469-04-022170']","['0000064670-13-000003', '0000064670-13-000012', '0000064670-13-000024', '0000064670-14-000005', '0000064670-14-000018', '0000064670-14-000029', '0000064670-15-000005', '0000897101-01-500007', '0000897101-01-500810', '0000897101-02-000154', '0000897101-05-001958', '0000897101-05-002582', '0000897101-06-000543', '0000897101-06-001907', '0000897101-06-002501', '0000897101-07-000532', '0000897101-07-001892', '0000897101-07-002582', '0000897101-08-000478', '0000897101-08-001858', '0000897101-08-002439', '0000897101-09-000422', '0000897101-09-001825', '0000897101-09-002528', '0000897101-10-000491', '0000897101-10-001794', '0000897101-10-002408', '0000897101-11-000375', '0000897101-11-001555', '0000897101-11-002069', '0000897101-12-000400', '0000897101-12-001524', '0000897101-12-002104', '0000912057-01-531887', '0001104659-02-004455', '0001104659-02-006949', '0001104659-03-003813', '0001104659-03-020141', '0001104659-03-027937', '0001104659-04-006585', '0001104659-04-026723', '0001104659-04-038798', '0001104659-05-009815']",14,43,57
NWS,0001308161,NewsCorp,"['0001193125-05-179099', '0001193125-06-178355', '0001193125-07-187791', '0001193125-08-175187', '0001193125-09-172310', '0001193125-10-181329', '0001193125-11-221637', '0001193125-12-355856', '0001193125-13-338522', '0001564590-14-003642', '0001564590-15-007133', '0001564590-16-023961', '0001564590-17-017693', '0001564590-18-021493']","['0000950123-14-001222', '0000950123-18-004511', '0001193125-05-019927', '0001193125-05-097634', '0001193125-05-223253', '0001193125-06-024076', '0001193125-06-107898', '0001193125-06-228618', '0001193125-07-022629', '0001193125-07-108335', '0001193125-07-238696', '0001193125-08-021537', '0001193125-08-106177', '0001193125-08-226120', '0001193125-09-020197', '0001193125-09-101873', '0001193125-09-224062', '0001193125-10-020962', '0001193125-10-106827', '0001193125-10-246428', '0001193125-11-022139', '0001193125-11-126530', '0001193125-11-295489', '0001193125-12-047031', '0001193125-12-222598', '0001193125-12-460872', '0001193125-13-041558', '0001193125-13-214119', '0001193125-13-430281', '0001564590-14-001955', '0001564590-14-005307', '0001564590-15-000522', '0001564590-15-003463', '0001564590-15-009398', '0001564590-16-012471', '0001564590-16-017720', '0001564590-16-027051', '0001564590-17-001210', '0001564590-17-010311', '0001564590-17-022900', '0001564590-18-001566', '0001564590-18-028084', '0001564590-19-002155']",14,43,57
NXPI,0001193125,.,[],[],0,0,0
STE,1624899,1,"['0001624899-16-000005', '0001624899-17-000006', '0001624899-18-000003']","['0001624899-16-000004', '0001624899-16-000012', '0001624899-16-000015', '0001624899-17-000003', '0001624899-17-000009', '0001624899-17-000010', '0001624899-18-000002', '0001624899-18-000006', '0001624899-18-000009', '0001628280-19-001177']",3,10,13
STE,815065,2,"['0000815065-12-000006', '0000815065-13-000006', '0000815065-14-000004', '0000815065-15-000004', '0000950109-02-003429', '0000950130-03-003961', '0000950130-10-000911', '0001193125-04-102730', '0001193125-05-125285', '0001193125-06-128380', '0001193125-07-124946', '0001193125-08-125772', '0001193125-09-120940', '0001445305-11-001008']","['0000815065-11-000011', '0000815065-12-000004', '0000815065-12-000016', '0000815065-12-000021', '0000815065-13-000003', '0000815065-13-000012', '0000815065-13-000014', '0000815065-14-000002', '0000815065-14-000008', '0000815065-14-000012', '0000815065-15-000008', '0000815065-15-000009', '0000950109-01-504805', '0000950109-02-004109', '0000950131-03-000569', '0001021408-01-504754', '0001021408-02-001616', '0001021408-02-013716', '0001193125-03-035683', '0001193125-03-077446', '0001193125-04-019463', '0001193125-04-135211', '0001193125-04-187852', '0001193125-05-022163', '0001193125-05-162064', '0001193125-05-220833', '0001193125-06-021929', '0001193125-06-165791', '0001193125-06-226478', '0001193125-07-022541', '0001193125-07-173779', '0001193125-07-240044', '0001193125-08-023788', '0001193125-08-171665', '0001193125-08-231986', '0001193125-09-021159', '0001193125-09-168851', '0001193125-09-221423', '0001193125-10-025781', '0001193125-10-183374', '0001193125-10-253075', '0001445305-11-000201', '0001628280-15-000532']",14,43,57
VIAC,0000813828,CBS Corp,"['0000813828-15-000009', '0000813828-16-000065', '0000813828-17-000005', '0000813828-18-000018', '0000813828-19-000006', '0000813828-20-000013', '0000813828-21-000005', '0000950130-01-500372', '0001047469-03-010441', '0001047469-04-007840', '0001047469-05-006777', '0001047469-06-003576', '0001047469-07-001525', '0001047469-08-001936', '0001047469-09-001824', '0001047469-10-001402', '0001047469-11-001419', '0001047469-13-001192', '0001047469-14-000934']","['0000813828-14-000018', '0000813828-15-000018', '0000813828-15-000045', '0000813828-15-000053', '0000813828-16-000075', '0000813828-16-000088', '0000813828-16-000106', '0000813828-17-000013', '0000813828-17-000031', '0000813828-17-000048', '0000813828-18-000026', '0000813828-18-000036', '0000813828-18-000044', '0000813828-19-000014', '0000813828-19-000025', '0000813828-19-000033', '0000813828-20-000022', '0000813828-20-000040', '0000813828-20-000051', '0000813828-21-000009', '0000813828-21-000026', '0000813828-21-000040', '0000912057-02-020123', '0000912057-02-031808', '0000912057-02-042460', '0000950130-01-501623', '0000950130-01-503902', '0000950130-01-505390', '0001047469-03-018924', '0001047469-03-027487', '0001047469-03-036369', '0001047469-04-016480', '0001047469-04-025702', '0001047469-05-014195', '0001047469-05-020885', '0001047469-05-026375', '0001047469-06-006662', '0001047469-06-010520', '0001047469-06-013595', '0001047469-07-003701', '0001047469-07-006035', '0001047469-07-008435', '0001047469-08-005755', '0001047469-08-008646', '0001047469-08-011595', '0001047469-09-005171', '0001047469-09-007300', '0001047469-09-009610', '0001047469-10-004823', '0001047469-10-006913', '0001047469-10-009233', '0001047469-11-004480', '0001047469-11-006845', '0001047469-11-008999', '0001047469-12-005106', '0001047469-12-007699', '0001047469-13-005254', '0001047469-13-007929', '0001047469-13-010325', '0001047469-14-006759']",19,60,79
VIAC,0001339947,Viacom Inc,"['0001047469-06-003584', '0001193125-07-043859', '0001193125-08-042040', '0001193125-09-026502', '0001193125-10-028165', '0001193125-10-257767', '0001193125-12-471870', '0001193125-13-441356', '0001339947-14-000050', '0001339947-15-000042', '0001339947-16-000110', '0001339947-17-000049', '0001339947-18-000046', '0001339947-19-000043']","['0001047469-06-007083', '0001047469-06-010662', '0001047469-06-013823', '0001193125-07-109811', '0001193125-07-169232', '0001193125-07-233589', '0001193125-08-100381', '0001193125-08-160288', '0001193125-08-223066', '0001193125-09-093372', '0001193125-09-156564', '0001193125-09-221448', '0001193125-10-098207', '0001193125-10-178455', '0001193125-11-022662', '0001193125-11-113734', '0001193125-11-211521', '0001193125-12-035760', '0001193125-12-206921', '0001193125-12-333732', '0001193125-13-031360', '0001339947-14-000016', '0001339947-14-000033', '0001339947-14-000042', '0001339947-15-000009', '0001339947-15-000024', '0001339947-15-000034', '0001339947-16-000055', '0001339947-16-000070', '0001339947-16-000099', '0001339947-17-000009', '0001339947-17-000025', '0001339947-17-000038', '0001339947-18-000009', '0001339947-18-000020', '0001339947-18-000033', '0001339947-19-000013', '0001339947-19-000027', '0001339947-19-000031']",14,39,53
WBA,0000104207,Walgreens Co,"['0000104207-00-500009', '0000104207-01-500009', '0000104207-02-000006', '0000104207-03-000011', '0000104207-04-000011', '0000104207-05-000018', '0000104207-07-000036', '0000104207-08-000093', '0000104207-09-000124', '0000104207-10-000098', '0000104207-11-000102', '0000104207-12-000098', '0000104207-13-000104', '0000104207-14-000104', '0001140361-06-015618']","['0000104207-00-500004', '0000104207-01-500003', '0000104207-01-500006', '0000104207-01-500008', '0000104207-02-000001', '0000104207-02-000002', '0000104207-02-000004', '0000104207-03-000001', '0000104207-03-000002', '0000104207-03-000005', '0000104207-04-000003', '0000104207-04-000006', '0000104207-04-000008', '0000104207-05-000002', '0000104207-05-000011', '0000104207-05-000014', '0000104207-06-000002', '0000104207-06-000010', '0000104207-06-000025', '0000104207-07-000006', '0000104207-07-000012', '0000104207-07-000024', '0000104207-07-000039', '0000104207-08-000009', '0000104207-08-000016', '0000104207-09-000003', '0000104207-09-000040', '0000104207-09-000063', '0000104207-10-000005', '0000104207-10-000039', '0000104207-10-000059', '0000104207-11-000005', '0000104207-11-000022', '0000104207-11-000046', '0000104207-11-000119', '0000104207-12-000021', '0000104207-12-000040', '0000104207-12-000129', '0000104207-13-000031', '0000104207-13-000051', '0000104207-13-000141', '0000104207-14-000027', '0000104207-14-000050', '0001140361-14-046621']",15,44,59
